Patient	Patient identifier (used for downstream analysis)	 
LHC_ID	Patient identifier	
MNG_ID	Patient identifier	
RNASeq_ID	Sample identifier for RNASeq samples	
RNASeq_T	Sample label for RNASeq tumor samples	
RNASeq_NT	Sample label for RNASeq nontumor samples
WES_ID	Sample identifier for WES
WES_T	Sample label for WES tumor samples
WES_NT	Sample label for WES nontumor samples	
age	Patient age
age_bin	Binarized patient age [<60:0, >=60:1]
sex	Patient sex [female:0, male:1]
stage	Tumor stage [early(<=2):0, advanced(>=3):1]
tumor_size	Tumor size [small(<=5cm):0, large(>5cm):1]
multinodular	tumor is multinodular [no:0, yes:1]
TNM_staging	TNM staging [1-4]	
cirrhosis	Cirrhosis [no:0, yes:1]
hcv	HCV infection status [no:0, yes:1]	
hbv	HBV infection status [no:0, yes:1]
hdv	HDV infection status [no:0, yes:1]
survival.status	Survival status [alive:0, dead:1]	
survival.time	Survival time (days from diagnosis)
BMI	Patient body mass index
obesity	Obesity (BMI>=25) [no:0, yes:1] 
alcohol	Patient history of drinking alcohol [no:0, yes:1]
smoker	Patient history of smoking [no:0, yes:1]
FHx_LC	Patient has family history of liver cancer [no:0, yes:1]
alb	Albumin [normal:0, abnormal:1] Normal is > 35 g/L
bil	Bilirubin [normal:0, abnormal:1] Normal is < 20.5 micromol/L
alt	ALT [normal:0, abnormal:1] Normal is < 40 IU/L
afp	AFP [normal:0, abnormal:1] Normal is < 20 IU/mL
